"filename", "language", "XML", "Java", "comment", "blank", "total"
"d:\Programing\java\FinalProject\demo\pom.xml", "XML", 29, 0, 0, 0, 29
"d:\Programing\java\FinalProject\demo\src\main\java\thefinal\App.java", "Java", 0, 2, 0, 0, 2
"d:\Programing\java\FinalProject\demo\src\main\java\thefinal\GlobalModel.java", "Java", 0, 6, 1, 2, 9
"d:\Programing\java\FinalProject\demo\src\main\java\thefinal\SceneSystem\ActorFactory.java", "Java", 0, -9, 0, -3, -12
"d:\Programing\java\FinalProject\demo\src\main\java\thefinal\SceneSystem\ActorObject.java", "Java", 0, 27, 12, 5, 44
"d:\Programing\java\FinalProject\demo\src\main\java\thefinal\SceneSystem\CanvasFileSystem.java", "Java", 0, 103, 4, 13, 120
"d:\Programing\java\FinalProject\demo\src\main\java\thefinal\SceneSystem\SequenceGenerator.java", "Java", 0, 184, 5, 18, 207
"d:\Programing\java\FinalProject\demo\src\main\java\thefinal\SceneSystem\SmallPort.java", "Java", 0, -1, 0, 0, -1
"d:\Programing\java\FinalProject\demo\src\main\java\thefinal\SceneSystem\StageMouseListener.java", "Java", 0, 42, -1, 1, 42
"d:\Programing\java\FinalProject\demo\src\main\java\thefinal\SceneSystem\StageObject.java", "Java", 0, 19, 5, 1, 25
"d:\Programing\java\FinalProject\demo\src\main\java\thefinal\StageViewport.java", "Java", 0, 9, 0, 6, 15
"d:\Programing\java\FinalProject\demo\src\main\java\thefinal\guipart\ActorListGUI.java", "Java", 0, 53, 0, 11, 64
"d:\Programing\java\FinalProject\demo\src\main\java\thefinal\guipart\EditorGUI.java", "Java", 0, -13, 1, -1, -13
"d:\Programing\java\FinalProject\demo\src\main\java\thefinal\guipart\EditorGUIBtnActionListener.java", "Java", 0, 1, 0, 0, 1
"d:\Programing\java\FinalProject\demo\src\main\java\thefinal\guipart\InfoGUI.java", "Java", 0, 41, 2, 9, 52
"d:\Programing\java\FinalProject\demo\src\main\java\thefinal\guipart\PageSelectActionListener.java", "Java", 0, 1, 0, 0, 1
"d:\Programing\java\FinalProject\demo\src\main\java\thefinal\guipart\PageSelectPanel.java", "Java", 0, 9, -6, -1, 2
"d:\Programing\java\FinalProject\demo\src\main\java\thefinal\guipart\TextGUI.java", "Java", 0, 2, 0, 0, 2
"d:\Programing\java\FinalProject\demo\src\main\java\thefinal\guipart\TheGUI.java", "Java", 0, 29, 1, 9, 39
"d:\Programing\java\FinalProject\demo\src\test\java\thefinal\SceneSystem\SequenceGeneratorTest.java", "Java", 0, 68, 3, 15, 86
"d:\Programing\java\FinalProject\demo\target\classes\thefinal\App.class", "Java", 0, 3, 0, 0, 3
"d:\Programing\java\FinalProject\demo\target\classes\thefinal\SceneSystem\ActorFactory.class", "Java", 0, -10, 0, 0, -10
"d:\Programing\java\FinalProject\demo\target\classes\thefinal\SceneSystem\ActorObject.class", "Java", 0, 26, -8, 0, 18
"d:\Programing\java\FinalProject\demo\target\classes\thefinal\SceneSystem\CanvasFileSystem.class", "Java", 0, 77, 0, 1, 78
"d:\Programing\java\FinalProject\demo\target\classes\thefinal\SceneSystem\SequenceGenerator.class", "Java", 0, 90, 36, 1, 127
"d:\Programing\java\FinalProject\demo\target\classes\thefinal\SceneSystem\StageMouseListener.class", "Java", 0, 18, 0, 0, 18
"d:\Programing\java\FinalProject\demo\target\classes\thefinal\SceneSystem\StageObject.class", "Java", 0, 9, 0, 2, 11
"d:\Programing\java\FinalProject\demo\target\classes\thefinal\StageViewport.class", "Java", 0, 10, 0, 0, 10
"d:\Programing\java\FinalProject\demo\target\classes\thefinal\guipart\ActorListGUI$1.class", "Java", 0, 13, 0, 0, 13
"d:\Programing\java\FinalProject\demo\target\classes\thefinal\guipart\ActorListGUI.class", "Java", 0, 32, 0, 0, 32
"d:\Programing\java\FinalProject\demo\target\classes\thefinal\guipart\EditorGUI$1.class", "Java", 0, -3, 0, 0, -3
"d:\Programing\java\FinalProject\demo\target\classes\thefinal\guipart\EditorGUI$2.class", "Java", 0, -10, 0, 0, -10
"d:\Programing\java\FinalProject\demo\target\classes\thefinal\guipart\EditorGUI$3.class", "Java", 0, -9, 0, 0, -9
"d:\Programing\java\FinalProject\demo\target\classes\thefinal\guipart\EditorGUI$ColorPickerActionListener.class", "Java", 0, 12, 2, 0, 14
"d:\Programing\java\FinalProject\demo\target\classes\thefinal\guipart\EditorGUI$DelPageActionListener.class", "Java", 0, 12, 0, 0, 12
"d:\Programing\java\FinalProject\demo\target\classes\thefinal\guipart\EditorGUI$NewPageActionListener.class", "Java", 0, 14, 0, 0, 14
"d:\Programing\java\FinalProject\demo\target\classes\thefinal\guipart\EditorGUI$TempShit.class", "Java", 0, -12, -2, 0, -14
"d:\Programing\java\FinalProject\demo\target\classes\thefinal\guipart\EditorGUI$shapeSelectActionListener.class", "Java", 0, 11, 0, 0, 11
"d:\Programing\java\FinalProject\demo\target\classes\thefinal\guipart\EditorGUI.class", "Java", 0, -6, 0, 0, -6
"d:\Programing\java\FinalProject\demo\target\classes\thefinal\guipart\EditorGUIBtnActionListener.class", "Java", 0, -1, 0, 0, -1
"d:\Programing\java\FinalProject\demo\target\classes\thefinal\guipart\InfoGUI$1.class", "Java", 0, 1, 0, 0, 1
"d:\Programing\java\FinalProject\demo\target\classes\thefinal\guipart\InfoGUI$2.class", "Java", 0, 10, 0, 0, 10
"d:\Programing\java\FinalProject\demo\target\classes\thefinal\guipart\InfoGUI$3.class", "Java", 0, 13, 0, 1, 14
"d:\Programing\java\FinalProject\demo\target\classes\thefinal\guipart\InfoGUI.class", "Java", 0, 9, 0, 0, 9
"d:\Programing\java\FinalProject\demo\target\classes\thefinal\guipart\PageSelectPanel$1.class", "Java", 0, -17, 0, -1, -18
"d:\Programing\java\FinalProject\demo\target\classes\thefinal\guipart\PageSelectPanel$SmallPortMouseListenerImplementation.class", "Java", 0, 23, 0, 1, 24
"d:\Programing\java\FinalProject\demo\target\classes\thefinal\guipart\PageSelectPanel.class", "Java", 0, 0, -1, 0, -1
"d:\Programing\java\FinalProject\demo\target\classes\thefinal\guipart\QuickConstraintFactory.class", "Java", 0, -1, 0, 0, -1
"d:\Programing\java\FinalProject\demo\target\classes\thefinal\guipart\TextGUI.class", "Java", 0, -1, 0, 0, -1
"d:\Programing\java\FinalProject\demo\target\classes\thefinal\guipart\TheGUI$1.class", "Java", 0, -6, 0, 0, -6
"d:\Programing\java\FinalProject\demo\target\classes\thefinal\guipart\TheGUI$2.class", "Java", 0, 10, 0, 0, 10
"d:\Programing\java\FinalProject\demo\target\classes\thefinal\guipart\TheGUI$3.class", "Java", 0, 10, 0, 0, 10
"d:\Programing\java\FinalProject\demo\target\classes\thefinal\guipart\TheGUI$4.class", "Java", 0, 16, 0, 0, 16
"d:\Programing\java\FinalProject\demo\target\classes\thefinal\guipart\TheGUI.class", "Java", 0, 17, 0, 0, 17
"d:\Programing\java\FinalProject\demo\target\test-classes\thefinal\SceneSystem\SequenceGeneratorTest.class", "Java", 0, 87, 0, 1, 88
"Total", "-", 29, 1020, 54, 91, 1194