"filename", "language", "Markdown", "Java", "comment", "blank", "total"
"d:\Programing\java\FinalProject\demo\readme.md", "Markdown", 1024, 0, 0, 1, 1025
"d:\Programing\java\FinalProject\demo\src\main\java\thefinal\App.java", "Java", 0, 0, 3, 1, 4
"d:\Programing\java\FinalProject\demo\src\main\java\thefinal\SceneSystem\ActorObject.java", "Java", 0, 11, 0, 3, 14
"d:\Programing\java\FinalProject\demo\src\main\java\thefinal\SceneSystem\StageMouseListener.java", "Java", 0, 1, 0, 0, 1
"d:\Programing\java\FinalProject\demo\src\main\java\thefinal\SceneSystem\StageObject.java", "Java", 0, 6, 1, 1, 8
"d:\Programing\java\FinalProject\demo\src\main\java\thefinal\ViewModelSystem\ModelConstract.java", "Java", 0, -4, 0, -1, -5
"d:\Programing\java\FinalProject\demo\src\main\java\thefinal\ViewModelSystem\ModelMaintainer.java", "Java", 0, -20, -5, -5, -30
"d:\Programing\java\FinalProject\demo\src\main\java\thefinal\ViewModelSystem\ViewConstract.java", "Java", 0, -4, 0, -1, -5
"d:\Programing\java\FinalProject\demo\src\main\java\thefinal\ViewModelSystem\ViewMaintainer.java", "Java", 0, -29, -20, -5, -54
"d:\Programing\java\FinalProject\demo\src\main\java\thefinal\guipart\ActorListGUI.java", "Java", 0, 63, 8, 6, 77
"d:\Programing\java\FinalProject\demo\src\main\java\thefinal\guipart\InfoGUI.java", "Java", 0, -2, 0, 0, -2
"d:\Programing\java\FinalProject\demo\src\main\java\thefinal\pagepart\Page.java", "Java", 0, -27, -3, -8, -38
"d:\Programing\java\FinalProject\demo\src\main\java\thefinal\pagepart\PageManager.java", "Java", 0, -8, 0, -5, -13
"d:\Programing\java\FinalProject\demo\src\main\java\thefinal\pagepart\PageMouseMoveListener.java", "Java", 0, -61, -1, -18, -80
"d:\Programing\java\FinalProject\demo\src\main\java\thefinal\pagepart\PageObject.java", "Java", 0, -78, -7, -11, -96
"d:\Programing\java\FinalProject\demo\src\main\java\thefinal\pagepart\ShapePart\RectangleComponent.java", "Java", 0, -12, 0, -6, -18
"d:\Programing\java\FinalProject\demo\src\main\java\thefinal\pagepart\ShapePart\ShapeComponent.java", "Java", 0, -51, -13, -12, -76
"d:\Programing\java\FinalProject\demo\target\classes\thefinal\App.class", "Java", 0, -14, 0, 0, -14
"d:\Programing\java\FinalProject\demo\target\classes\thefinal\GlobalModel.class", "Java", 0, -35, 0, 0, -35
"d:\Programing\java\FinalProject\demo\target\classes\thefinal\SceneSystem\ActorObject.class", "Java", 0, -48, 0, -1, -49
"d:\Programing\java\FinalProject\demo\target\classes\thefinal\SceneSystem\CanvasFileSystem.class", "Java", 0, -77, 0, -1, -78
"d:\Programing\java\FinalProject\demo\target\classes\thefinal\SceneSystem\SequenceGenerator.class", "Java", 0, -90, -36, -1, -127
"d:\Programing\java\FinalProject\demo\target\classes\thefinal\SceneSystem\SmallPort.class", "Java", 0, -39, 0, -1, -40
"d:\Programing\java\FinalProject\demo\target\classes\thefinal\SceneSystem\StageMouseListener.class", "Java", 0, -42, 0, 0, -42
"d:\Programing\java\FinalProject\demo\target\classes\thefinal\SceneSystem\StageObject.class", "Java", 0, -49, -10, -2, -61
"d:\Programing\java\FinalProject\demo\target\classes\thefinal\StageViewport.class", "Java", 0, -10, 0, 0, -10
"d:\Programing\java\FinalProject\demo\target\classes\thefinal\ViewModelSystem\ModelConstract.class", "Java", 0, -2, 0, 0, -2
"d:\Programing\java\FinalProject\demo\target\classes\thefinal\ViewModelSystem\ModelMaintainer.class", "Java", 0, -16, 0, 0, -16
"d:\Programing\java\FinalProject\demo\target\classes\thefinal\ViewModelSystem\ViewConstract.class", "Java", 0, -3, 0, 0, -3
"d:\Programing\java\FinalProject\demo\target\classes\thefinal\ViewModelSystem\ViewMaintainer.class", "Java", 0, -19, 0, 0, -19
"d:\Programing\java\FinalProject\demo\target\classes\thefinal\guipart\ActorListGUI$1.class", "Java", 0, -13, 0, 0, -13
"d:\Programing\java\FinalProject\demo\target\classes\thefinal\guipart\ActorListGUI.class", "Java", 0, -32, 0, 0, -32
"d:\Programing\java\FinalProject\demo\target\classes\thefinal\guipart\EditorGUI$1.class", "Java", 0, -9, 0, 0, -9
"d:\Programing\java\FinalProject\demo\target\classes\thefinal\guipart\EditorGUI$ColorPickerActionListener.class", "Java", 0, -12, -2, 0, -14
"d:\Programing\java\FinalProject\demo\target\classes\thefinal\guipart\EditorGUI$DelPageActionListener.class", "Java", 0, -12, 0, 0, -12
"d:\Programing\java\FinalProject\demo\target\classes\thefinal\guipart\EditorGUI$NewPageActionListener.class", "Java", 0, -14, 0, 0, -14
"d:\Programing\java\FinalProject\demo\target\classes\thefinal\guipart\EditorGUI$shapeSelectActionListener.class", "Java", 0, -11, 0, 0, -11
"d:\Programing\java\FinalProject\demo\target\classes\thefinal\guipart\EditorGUI.class", "Java", 0, -34, 0, 0, -34
"d:\Programing\java\FinalProject\demo\target\classes\thefinal\guipart\EditorGUIBtnActionListener.class", "Java", 0, -39, 0, 0, -39
"d:\Programing\java\FinalProject\demo\target\classes\thefinal\guipart\InfoGUI$1.class", "Java", 0, -11, 0, 0, -11
"d:\Programing\java\FinalProject\demo\target\classes\thefinal\guipart\InfoGUI$2.class", "Java", 0, -10, 0, 0, -10
"d:\Programing\java\FinalProject\demo\target\classes\thefinal\guipart\InfoGUI$3.class", "Java", 0, -13, 0, -1, -14
"d:\Programing\java\FinalProject\demo\target\classes\thefinal\guipart\InfoGUI.class", "Java", 0, -75, 0, 0, -75
"d:\Programing\java\FinalProject\demo\target\classes\thefinal\guipart\InfoGUIUpdater.class", "Java", 0, -14, 0, 0, -14
"d:\Programing\java\FinalProject\demo\target\classes\thefinal\guipart\NumberInput\DoubleAreaListener.class", "Java", 0, -23, 0, 0, -23
"d:\Programing\java\FinalProject\demo\target\classes\thefinal\guipart\NumberInput\InputNumArea.class", "Java", 0, -6, 0, 0, -6
"d:\Programing\java\FinalProject\demo\target\classes\thefinal\guipart\NumberInput\IntAreaListener.class", "Java", 0, -22, 0, 0, -22
"d:\Programing\java\FinalProject\demo\target\classes\thefinal\guipart\PageSelectActionListener.class", "Java", 0, -12, 0, 0, -12
"d:\Programing\java\FinalProject\demo\target\classes\thefinal\guipart\PageSelectPanel$SmallPortMouseListenerImplementation.class", "Java", 0, -23, 0, -1, -24
"d:\Programing\java\FinalProject\demo\target\classes\thefinal\guipart\PageSelectPanel.class", "Java", 0, -32, -3, 0, -35
"d:\Programing\java\FinalProject\demo\target\classes\thefinal\guipart\QuickConstraintFactory.class", "Java", 0, -21, 0, 0, -21
"d:\Programing\java\FinalProject\demo\target\classes\thefinal\guipart\TextGUI$TextGUIActionListener.class", "Java", 0, -31, 0, 0, -31
"d:\Programing\java\FinalProject\demo\target\classes\thefinal\guipart\TextGUI.class", "Java", 0, -30, 0, 0, -30
"d:\Programing\java\FinalProject\demo\target\classes\thefinal\guipart\TheGUI$1.class", "Java", 0, -10, 0, 0, -10
"d:\Programing\java\FinalProject\demo\target\classes\thefinal\guipart\TheGUI$2.class", "Java", 0, -10, 0, 0, -10
"d:\Programing\java\FinalProject\demo\target\classes\thefinal\guipart\TheGUI$3.class", "Java", 0, -10, 0, 0, -10
"d:\Programing\java\FinalProject\demo\target\classes\thefinal\guipart\TheGUI$4.class", "Java", 0, -16, 0, 0, -16
"d:\Programing\java\FinalProject\demo\target\classes\thefinal\guipart\TheGUI.class", "Java", 0, -49, 0, -1, -50
"d:\Programing\java\FinalProject\demo\target\classes\thefinal\pagepart\Page.class", "Java", 0, -24, 0, 0, -24
"d:\Programing\java\FinalProject\demo\target\classes\thefinal\pagepart\PageManager.class", "Java", 0, -8, 0, 0, -8
"d:\Programing\java\FinalProject\demo\target\classes\thefinal\pagepart\PageMouseMoveListener.class", "Java", 0, -25, 0, 0, -25
"d:\Programing\java\FinalProject\demo\target\classes\thefinal\pagepart\PageObject.class", "Java", 0, -46, 0, -1, -47
"d:\Programing\java\FinalProject\demo\target\classes\thefinal\pagepart\ShapePart\RectangleComponent.class", "Java", 0, -10, 0, 0, -10
"d:\Programing\java\FinalProject\demo\target\classes\thefinal\pagepart\ShapePart\ShapeComponent.class", "Java", 0, -29, 0, 0, -29
"d:\Programing\java\FinalProject\demo\target\test-classes\thefinal\AppTest.class", "Java", 0, -11, 0, 0, -11
"d:\Programing\java\FinalProject\demo\target\test-classes\thefinal\SceneSystem\SequenceGeneratorTest.class", "Java", 0, -87, 0, -1, -88
"Total", "-", 1024, -1493, -88, -71, -628