"filename", "language", "XML", "Markdown", "Java", "comment", "blank", "total"
"d:\Programing\java\FinalProject\demo\pom.xml", "XML", 94, 0, 0, 4, 7, 105
"d:\Programing\java\FinalProject\demo\readme.md", "Markdown", 0, 1027, 0, 0, 2, 1029
"d:\Programing\java\FinalProject\demo\src\main\java\thefinal\App.java", "Java", 0, 0, 12, 10, 4, 26
"d:\Programing\java\FinalProject\demo\src\main\java\thefinal\GlobalModel.java", "Java", 0, 0, 63, 22, 15, 100
"d:\Programing\java\FinalProject\demo\src\main\java\thefinal\SceneSystem\ActorObject.java", "Java", 0, 0, 108, 43, 19, 170
"d:\Programing\java\FinalProject\demo\src\main\java\thefinal\SceneSystem\CanvasFileSystem.java", "Java", 0, 0, 103, 4, 13, 120
"d:\Programing\java\FinalProject\demo\src\main\java\thefinal\SceneSystem\SequenceGenerator.java", "Java", 0, 0, 184, 5, 18, 207
"d:\Programing\java\FinalProject\demo\src\main\java\thefinal\SceneSystem\SmallPort.java", "Java", 0, 0, 47, 2, 9, 58
"d:\Programing\java\FinalProject\demo\src\main\java\thefinal\SceneSystem\StageMouseListener.java", "Java", 0, 0, 96, 7, 21, 124
"d:\Programing\java\FinalProject\demo\src\main\java\thefinal\SceneSystem\StageObject.java", "Java", 0, 0, 89, 11, 14, 114
"d:\Programing\java\FinalProject\demo\src\main\java\thefinal\StageViewport.java", "Java", 0, 0, 9, 0, 6, 15
"d:\Programing\java\FinalProject\demo\src\main\java\thefinal\guipart\ActorListGUI.java", "Java", 0, 0, 116, 8, 17, 141
"d:\Programing\java\FinalProject\demo\src\main\java\thefinal\guipart\EditorGUI.java", "Java", 0, 0, 104, 10, 21, 135
"d:\Programing\java\FinalProject\demo\src\main\java\thefinal\guipart\EditorGUIBtnActionListener.java", "Java", 0, 0, 53, 0, 4, 57
"d:\Programing\java\FinalProject\demo\src\main\java\thefinal\guipart\InfoGUI.java", "Java", 0, 0, 149, 3, 27, 179
"d:\Programing\java\FinalProject\demo\src\main\java\thefinal\guipart\InfoGUIUpdater.java", "Java", 0, 0, 13, 1, 4, 18
"d:\Programing\java\FinalProject\demo\src\main\java\thefinal\guipart\NumberInput\DoubleAreaListener.java", "Java", 0, 0, 35, 4, 13, 52
"d:\Programing\java\FinalProject\demo\src\main\java\thefinal\guipart\NumberInput\InputNumArea.java", "Java", 0, 0, 7, 0, 4, 11
"d:\Programing\java\FinalProject\demo\src\main\java\thefinal\guipart\NumberInput\IntAreaListener.java", "Java", 0, 0, 34, 3, 10, 47
"d:\Programing\java\FinalProject\demo\src\main\java\thefinal\guipart\PageSelectActionListener.java", "Java", 0, 0, 14, 2, 3, 19
"d:\Programing\java\FinalProject\demo\src\main\java\thefinal\guipart\PageSelectPanel.java", "Java", 0, 0, 71, 1, 13, 85
"d:\Programing\java\FinalProject\demo\src\main\java\thefinal\guipart\QuickConstraintFactory.java", "Java", 0, 0, 31, 15, 7, 53
"d:\Programing\java\FinalProject\demo\src\main\java\thefinal\guipart\TextGUI.java", "Java", 0, 0, 77, 3, 11, 91
"d:\Programing\java\FinalProject\demo\src\main\java\thefinal\guipart\TheGUI.java", "Java", 0, 0, 116, 10, 22, 148
"d:\Programing\java\FinalProject\demo\src\test\java\thefinal\AppTest.java", "Java", 0, 0, 11, 6, 4, 21
"d:\Programing\java\FinalProject\demo\src\test\java\thefinal\SceneSystem\SequenceGeneratorTest.java", "Java", 0, 0, 68, 3, 15, 86
"Total", "-", 94, 1027, 1610, 177, 303, 3211