"filename", "language", "Java", "XML", "Markdown", "comment", "blank", "total"
"d:\Programing\java\FinalProject\demo\pom.xml", "XML", 0, 94, 0, 4, 7, 105
"d:\Programing\java\FinalProject\demo\readme.md", "Markdown", 0, 0, 1027, 0, 2, 1029
"d:\Programing\java\FinalProject\demo\src\main\java\thefinal\App.java", "Java", 12, 0, 0, 10, 4, 26
"d:\Programing\java\FinalProject\demo\src\main\java\thefinal\GlobalModel.java", "Java", 63, 0, 0, 22, 15, 100
"d:\Programing\java\FinalProject\demo\src\main\java\thefinal\SceneSystem\ActorObject.java", "Java", 108, 0, 0, 43, 19, 170
"d:\Programing\java\FinalProject\demo\src\main\java\thefinal\SceneSystem\CanvasFileSystem.java", "Java", 103, 0, 0, 4, 13, 120
"d:\Programing\java\FinalProject\demo\src\main\java\thefinal\SceneSystem\SequenceGenerator.java", "Java", 184, 0, 0, 5, 18, 207
"d:\Programing\java\FinalProject\demo\src\main\java\thefinal\SceneSystem\SmallPort.java", "Java", 47, 0, 0, 2, 9, 58
"d:\Programing\java\FinalProject\demo\src\main\java\thefinal\SceneSystem\StageMouseListener.java", "Java", 96, 0, 0, 7, 21, 124
"d:\Programing\java\FinalProject\demo\src\main\java\thefinal\SceneSystem\StageObject.java", "Java", 89, 0, 0, 11, 14, 114
"d:\Programing\java\FinalProject\demo\src\main\java\thefinal\StageViewport.java", "Java", 9, 0, 0, 0, 6, 15
"d:\Programing\java\FinalProject\demo\src\main\java\thefinal\guipart\ActorListGUI.java", "Java", 96, 0, 0, 4, 15, 115
"d:\Programing\java\FinalProject\demo\src\main\java\thefinal\guipart\ActorListSelectionListener.java", "Java", 24, 0, 0, 4, 5, 33
"d:\Programing\java\FinalProject\demo\src\main\java\thefinal\guipart\EditorGUI.java", "Java", 104, 0, 0, 10, 21, 135
"d:\Programing\java\FinalProject\demo\src\main\java\thefinal\guipart\EditorGUIBtnActionListener.java", "Java", 53, 0, 0, 0, 4, 57
"d:\Programing\java\FinalProject\demo\src\main\java\thefinal\guipart\InfoGUI.java", "Java", 149, 0, 0, 3, 27, 179
"d:\Programing\java\FinalProject\demo\src\main\java\thefinal\guipart\InfoGUIUpdater.java", "Java", 13, 0, 0, 1, 4, 18
"d:\Programing\java\FinalProject\demo\src\main\java\thefinal\guipart\NumberInput\DoubleAreaListener.java", "Java", 35, 0, 0, 4, 13, 52
"d:\Programing\java\FinalProject\demo\src\main\java\thefinal\guipart\NumberInput\InputNumArea.java", "Java", 7, 0, 0, 0, 4, 11
"d:\Programing\java\FinalProject\demo\src\main\java\thefinal\guipart\NumberInput\IntAreaListener.java", "Java", 34, 0, 0, 3, 10, 47
"d:\Programing\java\FinalProject\demo\src\main\java\thefinal\guipart\PageSelectActionListener.java", "Java", 14, 0, 0, 2, 3, 19
"d:\Programing\java\FinalProject\demo\src\main\java\thefinal\guipart\PageSelectPanel.java", "Java", 71, 0, 0, 1, 13, 85
"d:\Programing\java\FinalProject\demo\src\main\java\thefinal\guipart\QuickConstraintFactory.java", "Java", 31, 0, 0, 15, 7, 53
"d:\Programing\java\FinalProject\demo\src\main\java\thefinal\guipart\SearchListGUI.java", "Java", 53, 0, 0, 0, 8, 61
"d:\Programing\java\FinalProject\demo\src\main\java\thefinal\guipart\TextGUI.java", "Java", 100, 0, 0, 3, 17, 120
"d:\Programing\java\FinalProject\demo\src\main\java\thefinal\guipart\TheGUI.java", "Java", 125, 0, 0, 10, 24, 159
"d:\Programing\java\FinalProject\demo\src\test\java\thefinal\AppTest.java", "Java", 11, 0, 0, 6, 4, 21
"d:\Programing\java\FinalProject\demo\src\test\java\thefinal\SceneSystem\SequenceGeneratorTest.java", "Java", 68, 0, 0, 3, 15, 86
"Total", "-", 1699, 94, 1027, 177, 322, 3319