"filename", "language", "Java", "Markdown", "comment", "blank", "total"
"d:\Programing\java\FinalProject\demo\readme.md", "Markdown", 0, 3, 0, 1, 4
"d:\Programing\java\FinalProject\demo\src\main\java\thefinal\App.java", "Java", -3, 0, 3, 0, 0
"d:\Programing\java\FinalProject\demo\src\main\java\thefinal\GlobalModel.java", "Java", 5, 0, 0, 0, 5
"d:\Programing\java\FinalProject\demo\src\main\java\thefinal\GlobalTick.java", "Java", -32, 0, 0, -10, -42
"d:\Programing\java\FinalProject\demo\src\main\java\thefinal\SceneSystem\ActorFactory.java", "Java", 9, 0, 0, 3, 12
"d:\Programing\java\FinalProject\demo\src\main\java\thefinal\SceneSystem\ActorManager.java", "Java", -8, 0, -4, -4, -16
"d:\Programing\java\FinalProject\demo\src\main\java\thefinal\SceneSystem\ActorObject.java", "Java", 5, 0, 4, 1, 10
"d:\Programing\java\FinalProject\demo\src\main\java\thefinal\SceneSystem\StageMouseListener.java", "Java", 0, 0, 2, 0, 2
"d:\Programing\java\FinalProject\demo\src\main\java\thefinal\SceneSystem\StageObject.java", "Java", 3, 0, 1, 1, 5
"d:\Programing\java\FinalProject\demo\src\main\java\thefinal\guipart\DoubleAreaListener.java", "Java", 0, 0, 0, 2, 2
"d:\Programing\java\FinalProject\demo\src\main\java\thefinal\guipart\EditorGUI.java", "Java", 9, 0, 0, 4, 13
"d:\Programing\java\FinalProject\demo\src\main\java\thefinal\guipart\EditorGUIBtnActionListener.java", "Java", 76, 0, 6, 4, 86
"d:\Programing\java\FinalProject\demo\src\main\java\thefinal\guipart\InfoGUI.java", "Java", 2, 0, 0, 0, 2
"d:\Programing\java\FinalProject\demo\src\main\java\thefinal\guipart\QuickConstraintFactory.java", "Java", 31, 0, 15, 7, 53
"d:\Programing\java\FinalProject\demo\src\main\java\thefinal\guipart\TheGUI.java", "Java", 13, 0, 3, 2, 18
"d:\Programing\java\FinalProject\demo\src\main\java\thefinal\guipart\TickAble.java", "Java", -4, 0, 0, -2, -6
"d:\Programing\java\FinalProject\demo\target\classes\thefinal\App.class", "Java", -5, 0, 0, 0, -5
"d:\Programing\java\FinalProject\demo\target\classes\thefinal\GlobalModel.class", "Java", 1, 0, 0, 0, 1
"d:\Programing\java\FinalProject\demo\target\classes\thefinal\GlobalTick.class", "Java", -18, 0, 0, 0, -18
"d:\Programing\java\FinalProject\demo\target\classes\thefinal\SceneSystem\ActorFactory.class", "Java", 10, 0, 0, 0, 10
"d:\Programing\java\FinalProject\demo\target\classes\thefinal\SceneSystem\ActorManager.class", "Java", -9, 0, 0, 0, -9
"d:\Programing\java\FinalProject\demo\target\classes\thefinal\SceneSystem\ActorObject.class", "Java", 3, 0, 0, 1, 4
"d:\Programing\java\FinalProject\demo\target\classes\thefinal\SceneSystem\StageMouseListener.class", "Java", 1, 0, 0, 0, 1
"d:\Programing\java\FinalProject\demo\target\classes\thefinal\SceneSystem\StageObject.class", "Java", 0, 0, -6, 0, -6
"d:\Programing\java\FinalProject\demo\target\classes\thefinal\guipart\EditorGUI$1.class", "Java", 9, 0, 0, 0, 9
"d:\Programing\java\FinalProject\demo\target\classes\thefinal\guipart\EditorGUI.class", "Java", 1, 0, 0, 0, 1
"d:\Programing\java\FinalProject\demo\target\classes\thefinal\guipart\EditorGUIBtnActionListener.class", "Java", 51, 0, 0, 0, 51
"d:\Programing\java\FinalProject\demo\target\classes\thefinal\guipart\InfoGUI.class", "Java", -2, 0, 5, 0, 3
"d:\Programing\java\FinalProject\demo\target\classes\thefinal\guipart\QuickConstraintFactory.class", "Java", 22, 0, 0, 0, 22
"d:\Programing\java\FinalProject\demo\target\classes\thefinal\guipart\TheGUI$PageSelectActionListener.class", "Java", 15, 0, 0, 0, 15
"d:\Programing\java\FinalProject\demo\target\classes\thefinal\guipart\TheGUI.class", "Java", 5, 0, 0, 1, 6
"d:\Programing\java\FinalProject\demo\target\classes\thefinal\guipart\TickAble.class", "Java", -3, 0, 0, 0, -3
"Total", "-", 187, 3, 29, 11, 230