"filename", "language", "XML", "Java", "Markdown", "comment", "blank", "total"
"d:\Programing\java\FinalProject\demo\pom.xml", "XML", 65, 0, 0, 4, 7, 76
"d:\Programing\java\FinalProject\demo\readme.md", "Markdown", 0, 0, 3, 0, 1, 4
"d:\Programing\java\FinalProject\demo\src\main\java\thefinal\App.java", "Java", 0, 10, 0, 7, 3, 20
"d:\Programing\java\FinalProject\demo\src\main\java\thefinal\GlobalModel.java", "Java", 0, 23, 0, 3, 8, 34
"d:\Programing\java\FinalProject\demo\src\main\java\thefinal\SceneSystem\ActorFactory.java", "Java", 0, 9, 0, 0, 3, 12
"d:\Programing\java\FinalProject\demo\src\main\java\thefinal\SceneSystem\ActorObject.java", "Java", 0, 45, 0, 13, 8, 66
"d:\Programing\java\FinalProject\demo\src\main\java\thefinal\SceneSystem\StageMouseListener.java", "Java", 0, 47, 0, 4, 19, 70
"d:\Programing\java\FinalProject\demo\src\main\java\thefinal\SceneSystem\StageObject.java", "Java", 0, 60, 0, 4, 12, 76
"d:\Programing\java\FinalProject\demo\src\main\java\thefinal\guipart\DoubleAreaListener.java", "Java", 0, 32, 0, 5, 13, 50
"d:\Programing\java\FinalProject\demo\src\main\java\thefinal\guipart\EditorGUI.java", "Java", 0, 99, 0, 6, 19, 124
"d:\Programing\java\FinalProject\demo\src\main\java\thefinal\guipart\EditorGUIBtnActionListener.java", "Java", 0, 95, 0, 6, 7, 108
"d:\Programing\java\FinalProject\demo\src\main\java\thefinal\guipart\InfoGUI.java", "Java", 0, 88, 0, 1, 16, 105
"d:\Programing\java\FinalProject\demo\src\main\java\thefinal\guipart\InfoGUIUpdater.java", "Java", 0, 13, 0, 0, 5, 18
"d:\Programing\java\FinalProject\demo\src\main\java\thefinal\guipart\InputNumArea.java", "Java", 0, 7, 0, 0, 4, 11
"d:\Programing\java\FinalProject\demo\src\main\java\thefinal\guipart\IntAreaListener.java", "Java", 0, 30, 0, 3, 9, 42
"d:\Programing\java\FinalProject\demo\src\main\java\thefinal\guipart\QuickConstraintFactory.java", "Java", 0, 31, 0, 15, 7, 53
"d:\Programing\java\FinalProject\demo\src\main\java\thefinal\guipart\TheGUI.java", "Java", 0, 84, 0, 7, 13, 104
"d:\Programing\java\FinalProject\demo\src\main\java\thefinal\pagepart\Page.java", "Java", 0, 27, 0, 3, 7, 37
"d:\Programing\java\FinalProject\demo\src\main\java\thefinal\pagepart\PageManager.java", "Java", 0, 8, 0, 0, 5, 13
"d:\Programing\java\FinalProject\demo\src\main\java\thefinal\pagepart\PageMouseMoveListener.java", "Java", 0, 61, 0, 1, 18, 80
"d:\Programing\java\FinalProject\demo\src\main\java\thefinal\pagepart\PageObject.java", "Java", 0, 79, 0, 7, 11, 97
"d:\Programing\java\FinalProject\demo\src\main\java\thefinal\pagepart\ShapePart\RectangleComponent.java", "Java", 0, 15, 0, 0, 6, 21
"d:\Programing\java\FinalProject\demo\src\main\java\thefinal\pagepart\ShapePart\ShapeComponent.java", "Java", 0, 51, 0, 13, 12, 76
"d:\Programing\java\FinalProject\demo\src\test\java\thefinal\AppTest.java", "Java", 0, 11, 0, 6, 4, 21
"d:\Programing\java\FinalProject\demo\target\classes\thefinal\App.class", "Java", 0, 11, 0, 0, 0, 11
"d:\Programing\java\FinalProject\demo\target\classes\thefinal\GlobalModel.class", "Java", 0, 12, 0, 0, 0, 12
"d:\Programing\java\FinalProject\demo\target\classes\thefinal\SceneSystem\ActorFactory.class", "Java", 0, 10, 0, 0, 0, 10
"d:\Programing\java\FinalProject\demo\target\classes\thefinal\SceneSystem\ActorObject.class", "Java", 0, 20, 0, 0, 1, 21
"d:\Programing\java\FinalProject\demo\target\classes\thefinal\SceneSystem\StageMouseListener.class", "Java", 0, 21, 0, 0, 0, 21
"d:\Programing\java\FinalProject\demo\target\classes\thefinal\SceneSystem\StageObject.class", "Java", 0, 37, 0, 11, 0, 48
"d:\Programing\java\FinalProject\demo\target\classes\thefinal\guipart\DoubleAreaListener.class", "Java", 0, 21, 0, 0, 0, 21
"d:\Programing\java\FinalProject\demo\target\classes\thefinal\guipart\EditorGUI$1.class", "Java", 0, 9, 0, 0, 0, 9
"d:\Programing\java\FinalProject\demo\target\classes\thefinal\guipart\EditorGUI$TempShit.class", "Java", 0, 13, 0, 1, 0, 14
"d:\Programing\java\FinalProject\demo\target\classes\thefinal\guipart\EditorGUI.class", "Java", 0, 28, 0, 0, 0, 28
"d:\Programing\java\FinalProject\demo\target\classes\thefinal\guipart\EditorGUIBtnActionListener.class", "Java", 0, 68, 0, 0, 0, 68
"d:\Programing\java\FinalProject\demo\target\classes\thefinal\guipart\InfoGUI.class", "Java", 0, 49, 0, 5, 0, 54
"d:\Programing\java\FinalProject\demo\target\classes\thefinal\guipart\InfoGUIUpdater.class", "Java", 0, 14, 0, 0, 0, 14
"d:\Programing\java\FinalProject\demo\target\classes\thefinal\guipart\InputNumArea.class", "Java", 0, 6, 0, 0, 0, 6
"d:\Programing\java\FinalProject\demo\target\classes\thefinal\guipart\IntAreaListener.class", "Java", 0, 20, 0, 0, 0, 20
"d:\Programing\java\FinalProject\demo\target\classes\thefinal\guipart\QuickConstraintFactory.class", "Java", 0, 22, 0, 0, 0, 22
"d:\Programing\java\FinalProject\demo\target\classes\thefinal\guipart\TheGUI$PageSelectActionListener.class", "Java", 0, 15, 0, 0, 0, 15
"d:\Programing\java\FinalProject\demo\target\classes\thefinal\guipart\TheGUI.class", "Java", 0, 43, 0, 0, 1, 44
"d:\Programing\java\FinalProject\demo\target\classes\thefinal\pagepart\Page.class", "Java", 0, 24, 0, 0, 0, 24
"d:\Programing\java\FinalProject\demo\target\classes\thefinal\pagepart\PageManager.class", "Java", 0, 8, 0, 0, 0, 8
"d:\Programing\java\FinalProject\demo\target\classes\thefinal\pagepart\PageMouseMoveListener.class", "Java", 0, 25, 0, 0, 0, 25
"d:\Programing\java\FinalProject\demo\target\classes\thefinal\pagepart\PageObject.class", "Java", 0, 46, 0, 0, 1, 47
"d:\Programing\java\FinalProject\demo\target\classes\thefinal\pagepart\ShapePart\RectangleComponent.class", "Java", 0, 10, 0, 0, 0, 10
"d:\Programing\java\FinalProject\demo\target\classes\thefinal\pagepart\ShapePart\ShapeComponent.class", "Java", 0, 29, 0, 0, 0, 29
"d:\Programing\java\FinalProject\demo\target\test-classes\thefinal\AppTest.class", "Java", 0, 11, 0, 0, 0, 11
"Total", "-", 65, 1497, 3, 125, 220, 1910