"filename", "language", "XML", "Markdown", "Java", "comment", "blank", "total"
"d:\Programing\java\FinalProject\demo\pom.xml", "XML", 65, 0, 0, 4, 7, 76
"d:\Programing\java\FinalProject\demo\readme.md", "Markdown", 0, 3, 0, 0, 1, 4
"d:\Programing\java\FinalProject\demo\src\main\java\thefinal\App.java", "Java", 0, 0, 10, 7, 3, 20
"d:\Programing\java\FinalProject\demo\src\main\java\thefinal\GlobalModel.java", "Java", 0, 0, 57, 21, 13, 91
"d:\Programing\java\FinalProject\demo\src\main\java\thefinal\SceneSystem\ActorFactory.java", "Java", 0, 0, 9, 0, 3, 12
"d:\Programing\java\FinalProject\demo\src\main\java\thefinal\SceneSystem\ActorObject.java", "Java", 0, 0, 70, 31, 11, 112
"d:\Programing\java\FinalProject\demo\src\main\java\thefinal\SceneSystem\SmallPort.java", "Java", 0, 0, 48, 2, 9, 59
"d:\Programing\java\FinalProject\demo\src\main\java\thefinal\SceneSystem\StageMouseListener.java", "Java", 0, 0, 53, 8, 20, 81
"d:\Programing\java\FinalProject\demo\src\main\java\thefinal\SceneSystem\StageObject.java", "Java", 0, 0, 64, 5, 12, 81
"d:\Programing\java\FinalProject\demo\src\main\java\thefinal\ViewModelSystem\ModelConstract.java", "Java", 0, 0, 4, 0, 1, 5
"d:\Programing\java\FinalProject\demo\src\main\java\thefinal\ViewModelSystem\ModelMaintainer.java", "Java", 0, 0, 20, 5, 5, 30
"d:\Programing\java\FinalProject\demo\src\main\java\thefinal\ViewModelSystem\ViewConstract.java", "Java", 0, 0, 4, 0, 1, 5
"d:\Programing\java\FinalProject\demo\src\main\java\thefinal\ViewModelSystem\ViewMaintainer.java", "Java", 0, 0, 29, 20, 5, 54
"d:\Programing\java\FinalProject\demo\src\main\java\thefinal\guipart\EditorGUI.java", "Java", 0, 0, 117, 9, 22, 148
"d:\Programing\java\FinalProject\demo\src\main\java\thefinal\guipart\EditorGUIBtnActionListener.java", "Java", 0, 0, 52, 0, 4, 56
"d:\Programing\java\FinalProject\demo\src\main\java\thefinal\guipart\InfoGUI.java", "Java", 0, 0, 110, 1, 18, 129
"d:\Programing\java\FinalProject\demo\src\main\java\thefinal\guipart\InfoGUIUpdater.java", "Java", 0, 0, 13, 1, 4, 18
"d:\Programing\java\FinalProject\demo\src\main\java\thefinal\guipart\NumberInput\DoubleAreaListener.java", "Java", 0, 0, 35, 4, 13, 52
"d:\Programing\java\FinalProject\demo\src\main\java\thefinal\guipart\NumberInput\InputNumArea.java", "Java", 0, 0, 7, 0, 4, 11
"d:\Programing\java\FinalProject\demo\src\main\java\thefinal\guipart\NumberInput\IntAreaListener.java", "Java", 0, 0, 34, 3, 10, 47
"d:\Programing\java\FinalProject\demo\src\main\java\thefinal\guipart\PageSelectActionListener.java", "Java", 0, 0, 13, 2, 3, 18
"d:\Programing\java\FinalProject\demo\src\main\java\thefinal\guipart\PageSelectPanel.java", "Java", 0, 0, 62, 7, 14, 83
"d:\Programing\java\FinalProject\demo\src\main\java\thefinal\guipart\QuickConstraintFactory.java", "Java", 0, 0, 31, 15, 7, 53
"d:\Programing\java\FinalProject\demo\src\main\java\thefinal\guipart\TextGUI.java", "Java", 0, 0, 75, 3, 11, 89
"d:\Programing\java\FinalProject\demo\src\main\java\thefinal\guipart\TheGUI.java", "Java", 0, 0, 87, 9, 13, 109
"d:\Programing\java\FinalProject\demo\src\main\java\thefinal\pagepart\Page.java", "Java", 0, 0, 27, 3, 8, 38
"d:\Programing\java\FinalProject\demo\src\main\java\thefinal\pagepart\PageManager.java", "Java", 0, 0, 8, 0, 5, 13
"d:\Programing\java\FinalProject\demo\src\main\java\thefinal\pagepart\PageMouseMoveListener.java", "Java", 0, 0, 61, 1, 18, 80
"d:\Programing\java\FinalProject\demo\src\main\java\thefinal\pagepart\PageObject.java", "Java", 0, 0, 78, 7, 11, 96
"d:\Programing\java\FinalProject\demo\src\main\java\thefinal\pagepart\ShapePart\RectangleComponent.java", "Java", 0, 0, 12, 0, 6, 18
"d:\Programing\java\FinalProject\demo\src\main\java\thefinal\pagepart\ShapePart\ShapeComponent.java", "Java", 0, 0, 51, 13, 12, 76
"d:\Programing\java\FinalProject\demo\src\test\java\thefinal\AppTest.java", "Java", 0, 0, 11, 6, 4, 21
"d:\Programing\java\FinalProject\demo\target\classes\thefinal\App.class", "Java", 0, 0, 11, 0, 0, 11
"d:\Programing\java\FinalProject\demo\target\classes\thefinal\GlobalModel.class", "Java", 0, 0, 35, 0, 0, 35
"d:\Programing\java\FinalProject\demo\target\classes\thefinal\SceneSystem\ActorFactory.class", "Java", 0, 0, 10, 0, 0, 10
"d:\Programing\java\FinalProject\demo\target\classes\thefinal\SceneSystem\ActorObject.class", "Java", 0, 0, 22, 8, 1, 31
"d:\Programing\java\FinalProject\demo\target\classes\thefinal\SceneSystem\SmallPort.class", "Java", 0, 0, 39, 0, 1, 40
"d:\Programing\java\FinalProject\demo\target\classes\thefinal\SceneSystem\StageMouseListener.class", "Java", 0, 0, 24, 0, 0, 24
"d:\Programing\java\FinalProject\demo\target\classes\thefinal\SceneSystem\StageObject.class", "Java", 0, 0, 40, 10, 0, 50
"d:\Programing\java\FinalProject\demo\target\classes\thefinal\ViewModelSystem\ModelConstract.class", "Java", 0, 0, 2, 0, 0, 2
"d:\Programing\java\FinalProject\demo\target\classes\thefinal\ViewModelSystem\ModelMaintainer.class", "Java", 0, 0, 16, 0, 0, 16
"d:\Programing\java\FinalProject\demo\target\classes\thefinal\ViewModelSystem\ViewConstract.class", "Java", 0, 0, 3, 0, 0, 3
"d:\Programing\java\FinalProject\demo\target\classes\thefinal\ViewModelSystem\ViewMaintainer.class", "Java", 0, 0, 19, 0, 0, 19
"d:\Programing\java\FinalProject\demo\target\classes\thefinal\guipart\EditorGUI$1.class", "Java", 0, 0, 12, 0, 0, 12
"d:\Programing\java\FinalProject\demo\target\classes\thefinal\guipart\EditorGUI$2.class", "Java", 0, 0, 10, 0, 0, 10
"d:\Programing\java\FinalProject\demo\target\classes\thefinal\guipart\EditorGUI$3.class", "Java", 0, 0, 9, 0, 0, 9
"d:\Programing\java\FinalProject\demo\target\classes\thefinal\guipart\EditorGUI$TempShit.class", "Java", 0, 0, 12, 2, 0, 14
"d:\Programing\java\FinalProject\demo\target\classes\thefinal\guipart\EditorGUI.class", "Java", 0, 0, 40, 0, 0, 40
"d:\Programing\java\FinalProject\demo\target\classes\thefinal\guipart\EditorGUIBtnActionListener.class", "Java", 0, 0, 40, 0, 0, 40
"d:\Programing\java\FinalProject\demo\target\classes\thefinal\guipart\InfoGUI$1.class", "Java", 0, 0, 10, 0, 0, 10
"d:\Programing\java\FinalProject\demo\target\classes\thefinal\guipart\InfoGUI.class", "Java", 0, 0, 66, 0, 0, 66
"d:\Programing\java\FinalProject\demo\target\classes\thefinal\guipart\InfoGUIUpdater.class", "Java", 0, 0, 14, 0, 0, 14
"d:\Programing\java\FinalProject\demo\target\classes\thefinal\guipart\NumberInput\DoubleAreaListener.class", "Java", 0, 0, 23, 0, 0, 23
"d:\Programing\java\FinalProject\demo\target\classes\thefinal\guipart\NumberInput\InputNumArea.class", "Java", 0, 0, 6, 0, 0, 6
"d:\Programing\java\FinalProject\demo\target\classes\thefinal\guipart\NumberInput\IntAreaListener.class", "Java", 0, 0, 22, 0, 0, 22
"d:\Programing\java\FinalProject\demo\target\classes\thefinal\guipart\PageSelectActionListener.class", "Java", 0, 0, 12, 0, 0, 12
"d:\Programing\java\FinalProject\demo\target\classes\thefinal\guipart\PageSelectPanel$1.class", "Java", 0, 0, 17, 0, 1, 18
"d:\Programing\java\FinalProject\demo\target\classes\thefinal\guipart\PageSelectPanel.class", "Java", 0, 0, 32, 4, 0, 36
"d:\Programing\java\FinalProject\demo\target\classes\thefinal\guipart\QuickConstraintFactory.class", "Java", 0, 0, 22, 0, 0, 22
"d:\Programing\java\FinalProject\demo\target\classes\thefinal\guipart\TextGUI$TextGUIActionListener.class", "Java", 0, 0, 31, 0, 0, 31
"d:\Programing\java\FinalProject\demo\target\classes\thefinal\guipart\TextGUI.class", "Java", 0, 0, 31, 0, 0, 31
"d:\Programing\java\FinalProject\demo\target\classes\thefinal\guipart\TheGUI$1.class", "Java", 0, 0, 16, 0, 0, 16
"d:\Programing\java\FinalProject\demo\target\classes\thefinal\guipart\TheGUI.class", "Java", 0, 0, 32, 0, 1, 33
"d:\Programing\java\FinalProject\demo\target\classes\thefinal\pagepart\Page.class", "Java", 0, 0, 24, 0, 0, 24
"d:\Programing\java\FinalProject\demo\target\classes\thefinal\pagepart\PageManager.class", "Java", 0, 0, 8, 0, 0, 8
"d:\Programing\java\FinalProject\demo\target\classes\thefinal\pagepart\PageMouseMoveListener.class", "Java", 0, 0, 25, 0, 0, 25
"d:\Programing\java\FinalProject\demo\target\classes\thefinal\pagepart\PageObject.class", "Java", 0, 0, 46, 0, 1, 47
"d:\Programing\java\FinalProject\demo\target\classes\thefinal\pagepart\ShapePart\RectangleComponent.class", "Java", 0, 0, 10, 0, 0, 10
"d:\Programing\java\FinalProject\demo\target\classes\thefinal\pagepart\ShapePart\ShapeComponent.class", "Java", 0, 0, 29, 0, 0, 29
"d:\Programing\java\FinalProject\demo\target\test-classes\thefinal\AppTest.class", "Java", 0, 0, 11, 0, 0, 11
"Total", "-", 65, 3, 2083, 211, 283, 2645