"filename", "language", "XML", "Java", "comment", "blank", "total"
"d:\Programing\java\FinalProject\demo\pom.xml", "XML", 65, 0, 4, 7, 76
"d:\Programing\java\FinalProject\demo\src\main\java\thefinal\App.java", "Java", 0, 13, 4, 3, 20
"d:\Programing\java\FinalProject\demo\src\main\java\thefinal\GlobalModel.java", "Java", 0, 18, 3, 8, 29
"d:\Programing\java\FinalProject\demo\src\main\java\thefinal\GlobalTick.java", "Java", 0, 32, 0, 10, 42
"d:\Programing\java\FinalProject\demo\src\main\java\thefinal\SceneSystem\ActorManager.java", "Java", 0, 8, 4, 4, 16
"d:\Programing\java\FinalProject\demo\src\main\java\thefinal\SceneSystem\ActorObject.java", "Java", 0, 40, 9, 7, 56
"d:\Programing\java\FinalProject\demo\src\main\java\thefinal\SceneSystem\StageMouseListener.java", "Java", 0, 47, 2, 19, 68
"d:\Programing\java\FinalProject\demo\src\main\java\thefinal\SceneSystem\StageObject.java", "Java", 0, 57, 3, 11, 71
"d:\Programing\java\FinalProject\demo\src\main\java\thefinal\guipart\DoubleAreaListener.java", "Java", 0, 32, 5, 11, 48
"d:\Programing\java\FinalProject\demo\src\main\java\thefinal\guipart\EditorGUI.java", "Java", 0, 90, 6, 15, 111
"d:\Programing\java\FinalProject\demo\src\main\java\thefinal\guipart\EditorGUIBtnActionListener.java", "Java", 0, 19, 0, 3, 22
"d:\Programing\java\FinalProject\demo\src\main\java\thefinal\guipart\InfoGUI.java", "Java", 0, 86, 1, 16, 103
"d:\Programing\java\FinalProject\demo\src\main\java\thefinal\guipart\InfoGUIUpdater.java", "Java", 0, 13, 0, 5, 18
"d:\Programing\java\FinalProject\demo\src\main\java\thefinal\guipart\InputNumArea.java", "Java", 0, 7, 0, 4, 11
"d:\Programing\java\FinalProject\demo\src\main\java\thefinal\guipart\IntAreaListener.java", "Java", 0, 30, 3, 9, 42
"d:\Programing\java\FinalProject\demo\src\main\java\thefinal\guipart\TheGUI.java", "Java", 0, 71, 4, 11, 86
"d:\Programing\java\FinalProject\demo\src\main\java\thefinal\guipart\TickAble.java", "Java", 0, 4, 0, 2, 6
"d:\Programing\java\FinalProject\demo\src\main\java\thefinal\pagepart\Page.java", "Java", 0, 27, 3, 7, 37
"d:\Programing\java\FinalProject\demo\src\main\java\thefinal\pagepart\PageManager.java", "Java", 0, 8, 0, 5, 13
"d:\Programing\java\FinalProject\demo\src\main\java\thefinal\pagepart\PageMouseMoveListener.java", "Java", 0, 61, 1, 18, 80
"d:\Programing\java\FinalProject\demo\src\main\java\thefinal\pagepart\PageObject.java", "Java", 0, 79, 7, 11, 97
"d:\Programing\java\FinalProject\demo\src\main\java\thefinal\pagepart\ShapePart\RectangleComponent.java", "Java", 0, 15, 0, 6, 21
"d:\Programing\java\FinalProject\demo\src\main\java\thefinal\pagepart\ShapePart\ShapeComponent.java", "Java", 0, 51, 13, 12, 76
"d:\Programing\java\FinalProject\demo\src\test\java\thefinal\AppTest.java", "Java", 0, 11, 6, 4, 21
"d:\Programing\java\FinalProject\demo\target\classes\thefinal\App.class", "Java", 0, 16, 0, 0, 16
"d:\Programing\java\FinalProject\demo\target\classes\thefinal\GlobalModel.class", "Java", 0, 11, 0, 0, 11
"d:\Programing\java\FinalProject\demo\target\classes\thefinal\GlobalTick.class", "Java", 0, 18, 0, 0, 18
"d:\Programing\java\FinalProject\demo\target\classes\thefinal\SceneSystem\ActorManager.class", "Java", 0, 9, 0, 0, 9
"d:\Programing\java\FinalProject\demo\target\classes\thefinal\SceneSystem\ActorObject.class", "Java", 0, 17, 0, 0, 17
"d:\Programing\java\FinalProject\demo\target\classes\thefinal\SceneSystem\StageMouseListener.class", "Java", 0, 20, 0, 0, 20
"d:\Programing\java\FinalProject\demo\target\classes\thefinal\SceneSystem\StageObject.class", "Java", 0, 37, 17, 0, 54
"d:\Programing\java\FinalProject\demo\target\classes\thefinal\guipart\DoubleAreaListener.class", "Java", 0, 21, 0, 0, 21
"d:\Programing\java\FinalProject\demo\target\classes\thefinal\guipart\EditorGUI$TempShit.class", "Java", 0, 13, 1, 0, 14
"d:\Programing\java\FinalProject\demo\target\classes\thefinal\guipart\EditorGUI.class", "Java", 0, 27, 0, 0, 27
"d:\Programing\java\FinalProject\demo\target\classes\thefinal\guipart\EditorGUIBtnActionListener.class", "Java", 0, 17, 0, 0, 17
"d:\Programing\java\FinalProject\demo\target\classes\thefinal\guipart\InfoGUI.class", "Java", 0, 51, 0, 0, 51
"d:\Programing\java\FinalProject\demo\target\classes\thefinal\guipart\InfoGUIUpdater.class", "Java", 0, 14, 0, 0, 14
"d:\Programing\java\FinalProject\demo\target\classes\thefinal\guipart\InputNumArea.class", "Java", 0, 6, 0, 0, 6
"d:\Programing\java\FinalProject\demo\target\classes\thefinal\guipart\IntAreaListener.class", "Java", 0, 20, 0, 0, 20
"d:\Programing\java\FinalProject\demo\target\classes\thefinal\guipart\TheGUI.class", "Java", 0, 38, 0, 0, 38
"d:\Programing\java\FinalProject\demo\target\classes\thefinal\guipart\TickAble.class", "Java", 0, 3, 0, 0, 3
"d:\Programing\java\FinalProject\demo\target\classes\thefinal\pagepart\Page.class", "Java", 0, 24, 0, 0, 24
"d:\Programing\java\FinalProject\demo\target\classes\thefinal\pagepart\PageManager.class", "Java", 0, 8, 0, 0, 8
"d:\Programing\java\FinalProject\demo\target\classes\thefinal\pagepart\PageMouseMoveListener.class", "Java", 0, 25, 0, 0, 25
"d:\Programing\java\FinalProject\demo\target\classes\thefinal\pagepart\PageObject.class", "Java", 0, 46, 0, 1, 47
"d:\Programing\java\FinalProject\demo\target\classes\thefinal\pagepart\ShapePart\RectangleComponent.class", "Java", 0, 10, 0, 0, 10
"d:\Programing\java\FinalProject\demo\target\classes\thefinal\pagepart\ShapePart\ShapeComponent.class", "Java", 0, 29, 0, 0, 29
"d:\Programing\java\FinalProject\demo\target\test-classes\thefinal\AppTest.class", "Java", 0, 11, 0, 0, 11
"Total", "-", 65, 1310, 96, 209, 1680